hug=həɡ
hard hat=hɑrd_hæt
greyhound='greɪ'haʊnd
chipmunk='tʃɪpməŋk
chimney='tʃɪmni
catch=kætʃ
shoes=ʃuz
shovel='ʃəvəl
fish=fɪʃ
three=θri
throne=θroʊn
moth=mɔθ
whistle='hwɪsəl
wheelchair='hwil,tʃɜr
whale=hweɪl
xylophone='zaɪlə,foʊn
fox=fɑks
taxi='tæksi
axe=æks
dog=dɔɡ
drum=drəm
hand=hænd
saddle='sædəl
poodle='pudəl
fiddle='fɪdəl
drink=drɪŋk
drop=drɑp
drill=drɪl
old=oʊld
cold=koʊld
gold=ɡoʊld
sandbox='sænd,bɑks
panda='pændə
skateboard='skeɪt,boʊrd
lizard='lɪzərd
jump=dʒəmp
jay=dʒeɪ
jeep=dʒip
ice=aɪs
tie=taɪ
life jacket=laɪf_'dʒækɪt
rabbit='ræbɪt
pencil='pɛnsəl
family='fæməli
hit=hɪt
mittens='mɪtɛnz
pig=pɪɡ
dig=dɪɡ
wig=wɪɡ
spill=spɪl
silver='sɪlvər
girl=ɡɜrl
bird=bɜrd
birthday cake='bɜrθ,deɪ_keɪk
sit=sɪt
monkey='məŋki
mole=moʊl
hamster='hæmstər
arm=ɑrm
armadillo=,ɑrmə'dɪl_oʊ
storm=stɔrm
trumpet='trəmpɪt
zebra='zɛbrə
dozer='doʊzər
suitcase='sut,keɪs
saint bernard=seɪnt_bɛR'nAR
dogs=dɑɡz
skis=skiz
poison='pɔɪzən
scarf=skɑrf
schoolbus=skulbəs
scratch=skrætʃ
skunk=skəŋk
skate=skeɪt
basket='bæskɪt
sled=slɛd
slippers='slɪpərz
slide=slaɪd
snail=sneɪl
snake=sneɪk
snow=snoʊ
spider='spaɪdər
spoon=spun
stilts=stɪltz
steal=stil
statue='stætʃu
sweet=swit
swing=swɪŋ
swan=swɑn
bus=bəs
cactus='kæktəs
walrus='wɔlrəs
ape=eɪp
tail=teɪl
canoe=kə'nu
sofa='soʊfə
father='fɑðər
squash=skwɑʃ
bat=bæt
cat=kæt
wagon='wæɡən
cake=keɪk
rake=reɪk
bake=beɪk
ball=bɔl
fall=fɔl
walnuts='wɔl,nət
man=mɑn
candy='kændi
star=stɑr
garden='ɡɑrdən
saw=sɔ
hawk=hɔk
draw=drɔ
canary=kə'nɜri
celery='sɛləri
face=feɪs
balance='bæləns
clown=klaʊn
clam=klæm
climb=klaɪm
crab=kræb
crane=kreɪn
cradle='kreɪdəl
nose=noʊz
nail=neɪl
lion='liɔn
king=kɪŋ
sing=sɪŋ
finger='fɪŋɡər
barn=bɑrn
corn=kɔrn
horn=hɔrn
nun=nun
bunny='bəni
yellow='jɛloʊ
yo-yo='joʊ_joʊ
crayons=kreɪɑnz
baby='beɪbi
sleepy='slipi
cry=kraɪ
fly=flaɪ
sky=skaɪ
silly='sɪli
hilly='hɪli
jellyfish='dʒɛli,fɪʃ
car=kɑr
chair=tʃɜr
horse=hɔrs
fork=fɔrk
dark=dɑrk
work=wɜrk
pearl=pɜrl
curl=kɜrl
bridge=brɪdʒ
break=breɪk
brush=brəʃ
frog=frɑɡ
frisbee='frizbi
frying pan=fraɪɪŋ_pæn
grape=greɪp
grass=græs
angry='æŋgri
proud=praʊd
pretzel='prɛtsəl
present='prɛzənt
tricycle='traɪsɪkəl
tree=tri
firetruck=faɪər,trək
turtle='tɜrtəl
purse=pɜrs
surfboard='sɜrf,boʊrd
goose=ɡus
goat=ɡoʊt
flag=flæɡ
giraffe=dʒə'ræf
gingerbread man='dʒɪndʒər,brɛd_mɑn
fridge=frɪdʒ
gloves=gləv
glass=glæs
juggler='dʒəglər
bug=bəɡ
plug=pləɡ
eat=it
eagle='iɡəl
camel='kæməl
hatchet='hætʃɪt
kitten='kɪtən
elf=ɛlf
bed=bɛd
net=nɛt
boxer='bɑksər
catcher='kætʃər
teeter-totter='titər_,tɑtər
pet=pɛt
rocket='rɑkɪt
volcano=vɑl'keɪnoʊ
van=vɑn
beaver='bivər
oven='əvən
love=ləv
glove=gləv
unicycle='junɪ,saɪkəl
binoculars=bɪ'nɑkjʊləz
utility knife=ju'tɪlɪti_naɪf
bucket='bəkɪt
blue=blu
tuba='tubə
bull=bʊl
bulldog='bʊl,dɔɡ
seagull='siɡəl
cut=kət
nuts=nəts
butterfly='bətər,flaɪ
mouth='maʊθ
cloud=klaʊd
mouse=mæʊs
leaf=lif
bell=bɛl
blanket='blæŋkɪt
bloodhound='bləd,haʊnd
flower='flaʊər
playground='pleɪ,graʊnd
airplane='ɜr,pleɪn
boy=bɔɪ
bubble='bəbəl
key=ki
kayak='kaɪæk
kangaroo=,kæŋɡə'ru
polar bear='poʊlər_bɜr
raccoons=ræ'kunz
boots=butz
onion='ənjən
ostrich='ɔstrɪtʃ
pot=pɑt
trolley='trɑli
hot=hɑt
robot='roʊbət
rainbow='reɪn,boʊ
bow and arrow=baʊ_ænd_'æroʊ
owl=aʊl
cow=kaʊ
town=taʊn
wolf=wʊlf
window='wɪndoʊ
toe=toʊ
traffic light='træfɪk_laɪt
hat=hæt
mother='məðər
feather='fɛðər
puppy='pəpi
penguin='pɛŋwɪn
carpet='kɑrpɪt
queen=kwin
question='kwɛstʃən
squirrel='skwɜrəl